
_,S,R,_,_
_,R,_,_,_
_,R,R,_,_
_,E,R,_,_
_,_,_,_,_
