_,_,_,_,_
_,_,R,R,_
E,R,S,_,_
_,_,R,R,_
_,_,_,_,_
