_,_,_,_,_
_,_,_,E,_
_,R,R,R,_
_,_,_,R,R
_,_,_,_,S
