_,_,_,_,_
_,_,R,_,_
_,R,S,R,E
R,R,_,_,_
_,_,_,_,_
