_,_,_,_,_
_,_,R,R,_
_,R,S,_,_
_,_,R,R,_
_,_,E,_,_
