_,S,_,_,_
_,R,_,_,_
_,R,R,_,_
_,_,R,_,_
_,E,R,_,_
