_,_,_,_,_
_,_,S,_,_
_,_,R,_,_
_,_,R,_,_
E,R,R,R,_
