
_,S,_,_,_
_,R,_,_,_
R,R,R,E,_
_,_,R,_,_
_,_,_,_,_
