_,_,_,_,_
_,_,_,_,_
R,_,_,_,_
R,R,S,_,_
_,_,R,R,E
