XXXXXXXXXXXDDDXXXXXXXXXXX
XXXXXXXXXXXXXXXXXXXXXXXXX
XXXXXXXXXXXXXXXXXXXXXXXXX
XXXXXXXXXXXXXXXXXXXXXXXXX
XXXXXXXXXXXXXXXXXXXXXXXXX
XXXXXXXXXXEXOXEXXXXXXXXXX
XXXXXXXXXXXXOXXXXXXXXXXXX
XXXXXXXXXOXXOXXOXXXXXXXXX
XXXXXXXXXOXXOXXOXXXXXXXXX
XXXXXXXXXOXXOXXOXXXXXXXXX
XXXXXXXXXOXXOXXOXXXXXXXXX
DXXXXXXXXXXXOXXXXXXXXXXXD
DXXXXXXXEXXXPXXXEXXXXXXXD
DXXXXXXXXXXXXXXXXXXXXXXXD
XXXXXXXXXOXXOXXOXXXXXXXXX
XXXXXXXXXOXXOXXOXXXXXXXXX
XXXXXXXXXOXXOXXOXXXXXXXXX
XXXXXXXXXOXXOXXOXXXXXXXXX
XXXXXXXXXOXXEXXOXXXXXXXXX
XXXXXXXXXOXXXXXOXXXXXXXXX
XXXXXXXXXXXXXXXXXXXXXXXXX
XXXXXXXXXXXXXXXXXXXXXXXXX
XXXXXXXXXXXXXXXXXXXXXXXXX
XXXXXXXXXXXXXXXXXXXXXXXXX
XXXXXXXXXXXDDDXXXXXXXXXXX
