XXXXXXXXXXXDDDXXXXXXXXXXX
XXXXXXXXXXXXXXXXXXXXXXXXX
XXXXXXXXXOXXXXXOXXXXXXXXX
XXXXXXXXXOXXXXXOXXXXXXXXX
XXXXXXXXXOXXEXXOXXXXXXXXX
XXXXXXXXXOXXXXXOXXXXXXXXX
XXXXXXXXXOXXXXXOXXXXXXXXX
XXXXXXXXXOXXXXXOXXXXXXXXX
XXXXXXXXXOXXXXXOXXXXXXXXX
XXXXXXXXXOXXXXXOXXXXXXXXX
XXXOXOXOXOXXXXXOXOXOXOXXX
DXXXXXXXXXXXXXXXXXXXXXXXD
DXXXEXXXXXXXPXXXXXXXEXXXD
DXXXXXXXXXXXXXXXXXXXXXXXD
XXXOXOXOXOXXXXXOXOXOXOXXX
XXXXXXXXXOXXXXXOXXXXXXXXX
XXXXXXXXXOXXXXXOXXXXXXXXX
XXXXXXXXXOXXXXXOXXXXXXXXX
XXXXXXXXXOXXXXXOXXXXXXXXX
XXXXXXXXXOXXXXXOXXXXXXXXX
XXXXXXXXXOXXEXXOXXXXXXXXX
XXXXXXXXXOXXXXXOXXXXXXXXX
XXXXXXXXXOXXXXXOXXXXXXXXX
XXXXXXXXXXXXXXXXXXXXXXXXX
XXXXXXXXXXXDDDXXXXXXXXXXX
