XXXXXXXXXXXDDDXXXXXXXXXXX
XXXXXXXXXXXXXXXXXXXXXXXXX
XXXXXXXXOOOOOOOOOXXXXXXXX
XXXXXXXXXXXXOXXXXXXXXXXXX
XXXXXXXXXXXXOXXXXXXXXXXXX
XXXXXXXXXXXXOXXXXXXXXXXXX
XXXXXXXXXXXXOXXXXXXXXXXXX
XXXXXXXXXXXXOXXXXXXXXXXXX
XXXXXXXXXXXXOXXXXXXXXXXXX
XXXXXXXOXEEEOXXXXXXXXXXXX
XXXXXXXOXEEEOXXXXXXXXXXXX
DXXXXXXXOOOOOXXXXXXXXXXXD
DXXXXXXXXXXXPXXXXXXXXXXXD
DXXXXXXXXXXXXXXXXXXXXXXXD
XXXXXXXXXXXXXXXXXXXXXXXXX
XXXXXXXXXXXXXXXXXXXXXXXXX
XXXXXXXXXXXXXXXXXXXXXXXXX
XXXXXXXXXXXXXXXXXXXXXXXXX
XXXXXXXXXXXXXXXXXXXXXXXXX
XXXXXXXXXXXXXXXXXXXXXXXXX
XXXXXXXXXXXXXXXXXXXXXXXXX
XXXXXXXXXXXXXXXXXXXXXXXXX
XXXXXXXXXXXXXXXXXXXXXXXXX
XXXXXXXXXXXXXXXXXXXXXXXXX
XXXXXXXXXXXDDDXXXXXXXXXXX
