XXXXXXXXXXXDDDXXXXXXXXXXX
XXXXXXXXXXXXXXXXXXXXXXXXX
XXXXXXXXXXXXXXXXXXXXXXXXX
XXXXXXXXXXXXXXXXXXXXXXXXX
XXXXXXXOXOXOXOXOXOXXXXXXX
XXXXXXXXXXXXEXXXXXXXXXXXX
XXXXXXXOXOXXXXXOXOXXXXXXX
XXXXXXXXXXXXXXXXXXXXXXXXX
XXXXXXXOXOXXXXXOXOXXXXXXX
XXXXXXXXXXXXXXXXXXXXXXXXX
XXXXXXXOXOXXXXXOXOXXXXXXX
DXXXXXXXXXXXXXXXXXXXXXXXD
DXXEXXXXXXXXPXXXXXXXXEXXD
DXXXXXXXXXXXXXXXXXXXXXXXD
XXXXXXXOXOXXXXXOXOXXXXXXX
XXXXXXXXXXXXXXXXXXXXXXXXX
XXXXXXXOXOXXXXXOXOXXXXXXX
XXXXXXXXXXXXEXXXXXXXXXXXX
XXXXXXXOXOXXXXXOXOXXXXXXX
XXXXXXXXXXXXXXXXXXXXXXXXX
XXXXXXXOXOXXXXXOXOXXXXXXX
XXXXXXXXXXXXXXXXXXXXXXXXX
XXXXXXXXXXXXXXXXXXXXXXXXX
XXXXXXXXXXXXXXXXXXXXXXXXX
XXXXXXXXXXXDDDXXXXXXXXXXX
