XXXXXXXXXXXDDDXXXXXXXXXXX
XXXXXXXXXXXXXXXXXXXXXXXXX
XXXXXXOXOXOXOXOXOXOXXXXXX
XXXXXXXXXXXXOXXXXXXXXXXXX
XXXXXXXXXXXXOXXXXXXXXXXXX
XXXXXXXEXXXXOXXXXEXXXXXXX
XXXXXXXXXXXXOXXXXXXXXXXXX
XXXXXXXXXXXXOXXXXXXXXXXXX
XXXXXXXXXXXXOXXXXXXXXXXXX
XXXXXXXXXXXXOXXXXXXOXXXXX
XXXXXXXXXXXXOXXXXXXOXXXXX
DXXXXXXXXXXXXOXOXOXXXXXXD
DXXXXXXXXXXXPXXXXXXXXXXXD
DXXXXXXXXXXXXXXXXXXXXXXXD
XXXXXXXXXXXXXXXXXXXXXXXXX
XXXXXXOXOXOXOXOXOXOXXXXXX
XXXXXXXXXXXXOXXXXXXXXXXXX
XXXXXXXXXXXXOXXXXXXXXEXXX
XXXXXXXEXXXXOXXXXXXXXXXXX
XXXXXXXXXXXXOXXXXXXXXXXXX
XXXXXXXXXXXXOXXXXXXXXXXXX
XXXXXXXXXXXXOXXXXXXXXXXXX
XXXXXXXXXXXXOXXXXXXXXXXXX
XXXXXXXXXXXXXXXXXXXXXXXXX
XXXXXXXXXXXDDDXXXXXXXXXXX
