XXXXXXXXXXXDDDXXXXXXXXXXX
XEOOXXXXXXXXXXXXXXXXXOOEX
XOOOXXXXXXXXXXXXXXXXXOOOX
XOOOXXXXXXXXXXXXXXXXXOOOX
XXXXXXXXXXXXXXXXXXXXXXXXX
XXXXXXXXXXXXXXXXXXXXXXXXX
XXXXXXXXXXXXXXXXXXXXXXXXX
XXXXXXXXXXXXXXXXXXXXXXXXX
XXXXXXXXXXXXXXXXXXXXXXXXX
XXXXXXXXXXXXXXXXXXXXXXXXX
XXXXXXXXXXXXXXXXXXXXXXXXX
DXXXXXXXXXXXXXXXXXXXXXXXD
DXXXXXXXXXXXPXXXXXXXXXXXD
DXXXXXXXXXXXXXXXXXXXXXXXD
XXXXXXXXXXXXXXXXXXXXXXXXX
XXXXXXXXXXXXXXXXXXXXXXXXX
XXXXXXXXXXXXXXXXXXXXXXXXX
XXXXXXXXXXXXXXXXXXXXXXXXX
XXXXXXXXXXXXXXXXXXXXXXXXX
XXXXXXXXXXXXXXXXXXXXXXXXX
XXXXXXXXXXXXXXXXXXXXXXXXX
XOOOXXXXXXXXXXXXXXXXXOOOX
XOOOXXXXXXXXXXXXXXXXXOOOX
XEOOXXXXXXXXXXXXXXXXXOOEX
XXXXXXXXXXXDDDXXXXXXXXXXX
