XXXXXXXXXXXDDDXXXXXXXXXXX
XXXXXXXXXXXXXXXXXXXXXXXXX
XXXXXXXXXXXXXXXXXXXXXXXXX
XXXXXXXXXXXXXXXXXXXXXXXXX
XXXOOOOOOOOOOOOOOOXXXXXXX
XXXXXXXXXXOEXXXXXXXXXXXXX
XXXXXXXXXXOXXXXXXXXXXXXXX
XXXXXXEXXXOXXXXXXXXXXXXXX
XXXXXXEXXXOXXXXXXXXXXXXXX
XXXXXXXXXXOXXXXXXXXXXXXXX
XXXXXXXXXXOXXXXXXXXXXXXXX
DXXXXXXXXXOXXXXXXXXXXXXXD
DXXXXXXXXXOXPXXXXXXXXXXXD
DXXXXXXXXXOXXXXXXXXXXXXXD
XXXXXXXXXXOXXXXXXXXXXXXXX
XXXXXXXXXXOXXXXXXXXXXXXXX
XXXXXXXXXXOXXXXXXXXXXXXXX
XXXXXXXXXXXXXXXXXXXXXXXXX
XXXXXXXXXXXXXXXXXXXXXXXXX
XXXXXXXXXXXXXXXXXXXXXXXXX
XXXXXXXXXXXXXXXXXXXXXXXXX
XXXXXXXXXXXXXXXXXXXXXXXXX
XXXXXXXXXXXXXXXXXXXXXXXXX
XXXXXXXXXXXXXXXXXXXXXXXXX
XXXXXXXXXXXDDDXXXXXXXXXXX
