XXXXXXXXXXXDDDXXXXXXXXXXX
XXXEXXXXXXXXXXXXXXXXXXXXX
XXXXXXXXXXXXXXXXXXXXXXXXX
XXXXXXXXXXXXXXXXXXXXXXXXX
XXXXXXXXXXXXXXXXXXXXXXXXX
XXXXXXXXXXXXXXXXXXXXXXXXX
XXXXXXXXXXXXXXXXXXXXEXXXX
XXXXXXOXXOXXXXXXXXXXXXXXX
XXXXXEOXXOXXXXXXOXXOXXXXX
XXXXXXOXXOXXXXXXOXXOXXXXX
XXXXXXOXXOXXXXXXOXXOXXXXX
DXXXXXXXXXXXXXXXOXXOXXXXD
DXXXXXXXXXXXPXXXXXXXXXXXD
DXXXXXXXXXXXXXXXXXXXXXXXD
XXXXXXXXXXXXXXXXXXXXXXXXX
XXXXXXXXXXXXXXXXXXXXXXXXX
XXXOXXOXXXXXXXXXXXXXXXXXX
XXXOXXOXXXXXXXXXXXXXXXXXX
XXXOXXOXXXXXXXXXXXXXXXXXX
XXXOXXOXXXXXXXXXXXOXXOXXX
XXXXEXXXXXXXXXXEXXOXXOXXX
XXXXXXXXXXXXXXXXXXOXXOXXX
XXXXXXXEXXXXXXXXXXOXXOXXX
XXXXXXXXXXXXXXXXXXXXXXXXX
XXXXXXXXXXXDDDXXXXXXXXXXX
