XXXXXXXXXXXDDDXXXXXXXXXXX
XXXXXXXXXXXXXXXXXXXXXXXXX
XXXXXXXXXXXXXXXXXXXXXXXXX
XXXXXXXXXXXXXXXXXXXXXXXXX
XXXXXXXXXXXXXXXXXXXXXXXXX
XXXXXXXXXXXXXXXXXXXXXXXXX
XXXXXXXXXXXXXXXXXXXXXXXXX
XXXXXXXXXXXXXXXXXXXXXXXXX
XXXXOXXXXXXXXXXXXXXXXXXXX
XXXXOOOXXXXXXXXXXXXXXXXXX
XXXXEXOOOOOOOOOOOOOOOXXXX
DXXXEXXXXOXOXXXXOXXXOXXXD
DXXXEXXOXXXOPXOXXXEXOXXXD
DXXXEXXOXOXXXXOXXXOXOXXXD
XXXXEXOOOOOOOOOOOOOOOXXXX
XXXXOOOXXXXXXXXXXXXXXXXXX
XXXXOXXXXXXXXXXXXXXXXXXXX
XXXXXXXXXXOOXXXXXXXXXXXXX
XXXXXXXXXXOOXXXXXXXXXXXXX
XXXXXXXXXXXXXXXXXXXXXXXXX
XXXXXXXXXXXXXXXXXXXXXXXXX
XXXXXXXXXXXXXXXXXXXXXXXXX
XXXXXXXXXXXXXXXXXXXXXXXXX
XXXXXXXXXXXXXXXXXXXXXXXXX
XXXXXXXXXXXDDDXXXXXXXXXXX
