XXXXXXXXXXXDDDXXXXXXXXXXX
XXXXXXXXXXXXXXXXXXXXXXXXX
XXXXXXXXXXXXXXXXXXXXXXXXX
XXXXXXXXXXXXXXXXXXXXXXXXX
XXXXXXXXXXXXXXXXXXXXXXXXX
XXXXXXXXXXXXXXXXXXXXXXXXX
XXXXXXXXXXXXXXXXXXXXXXXXX
XXXXXXOOOOXXXXXXXXXXXXXXX
XXXXXEOOOOXXXXXXOOOOEXXXX
XXXXXXOOOOXXXXXXOOOOXXXXX
XXXXXXOOOOXXXXXXOOOOXXEXX
DXXXXXXXXXXXXXXXOOOOXXXXD
DXXXXXXXXXXXPXXXXXXXXXXXD
DXXXXXXXXXXXXXXXXXXXXXXXD
XXXXXXXXXXXXXXXXXXXXXXXXX
XXXXXXXXXXXXXXXXXXXXXXXXX
XXXOOOOXXXXXXXXXXXXXXXXXX
XXXOOOOXXXXXXXXXXXXXXXXXX
XXXOOOOXXXXXXXXXXXXXXXXXX
XXXOOOOXXXXXXXXXXXOOOOXXX
XXXXEXXXXXXXXXXXXXOOOOEXX
XXXXXXXXXXXXXXXXXXOOOOXXX
XXXXXXXXXXXXXXXXXXOOOOXXX
XXXXXXXXXXXXXXXXXXXXEXXXX
XXXXXXXXXXXDDDXXXXXXXXXXX
