XXXXXXXXXXXDDDXXXXXXXXXXX
XEOXXXXXXXXXXXXXXXXXXXOEX
XOOXXXXXXXXXXXXXXXXXXXOOX
XXXXXXXXXXXXXXXXOOXXXXXXX
XXXXXXXXXXXXXXXXOOXXXXXXX
XXXXXXXXXXXXXXXXXXXXXXXXX
XXXXXXXOOXXXXXXXXXXXXXXXX
XXXXXXXOOOXXXXXXXXXXXXXXX
XXXXXXXOOOXXXXXXXXXXXXXXX
XXXXXXXXXXXXXXXXXOOOXXXXX
XXXXXXXXXXXXXXXXXOOOXXXXX
DXXXXXXXXXXXXXXXXXOOXXXXD
DXXXXXXXXXXXPXXXXXXXXXXXD
DXXXXXXXXXXXXXXXXXXXXXXXD
XXXXXXXXXXXXXXXXXXXXXXXXX
XXXXXXXXXXXXXXXOOOOXXXXXX
XXXOOOOOOXXXXXXOOOOXXXXXX
XXXOOOOOOXXXXXXOOOOXXXXXX
XXXOOOOOOXXXXXXOOOOXXXXXX
XXXOOOOOOXXXXXXXXXXXXXXXX
XXXOOOOOOXXXXXXXXXXXXXXXX
XXXXXXXXXXXXXXXXXXXXXXXXX
XOOXXXXXXXXXXXXXXXXXXXOOX
XEOXXXXXXXXXXXXXXXXXXXOEX
XXXXXXXXXXXDDDXXXXXXXXXXX
