XXXXXXXXXXXDDDXXXXXXXXXXX
XXXXXXXXXXXXXXXXXXXXXXXXX
XXXXXXXXXXXXXXXXXXXXXXXXX
XXXXXXXXXXXXXXXXXXXXXXXXX
XXXXXXXXXOXXXXXOXXXXXXXXX
XXXXXXXXXOXXXXXOXXXXXXXXX
XXXXXXXXXOXXXXXXXXXXXXXXX
XXXXXXXXXOXXXXXXXXXEXXXXX
XXXXXXXXXOXXXXXOXXXXXXXXX
XXXXXXXXXOXXXXXOXXXXXXXXX
XXXXXXXXXOXXXXXOXXXXXXXXX
DXXXXXXXXOXXXXXOXXXXXXXXD
DXXXXEXXXOXXPXXOXXXXXXXXD
DXXXXXXXXOXXXXXOXOXOXXXXD
XXXXXXXXXOXXXXXOXXXEXXXXX
XXXXXXXXXXXXXXXXOXOXXXXXX
XXXXXXXXXXXXXEXXOXOXXXXXX
XXXXXXXXXXXXXXXXXXXOXXXXX
XXXXXXXXXXXXXOXOXOXOXXXXX
XXXXXXXXXXXXXXXXXXXXXXXXX
XXXXXXXXXXXXXXXXXXXXXXXXX
XXXXXXXXXXXXXXXXXXXXXXXXX
XXXXXXXXXXXXXXXXXXXXXXXXX
XXXXXXXXXXXXXXXXXXXXXXXXX
XXXXXXXXXXXDDDXXXXXXXXXXX
