XXXXXXXXXXXDDDXXXXXXXXXXX
XXXXXXXXXXXXXXXXXXXXXXXXX
XXXXXXXXXXXXXXXXXXXXXXXXX
XXXXXXXXXXXXXXXXXXXXXXXXX
XXXXXXXXXXXOOEOOXXXXXXXXX
XXXXXXXXXXXOXXXOXXXXXXXXX
XXXXXXXXXXXXXXXXXXXXXXXXX
XXXXXXXXXXXOXOOOXXXXXXXXX
XXXXXXXXXXXOXXXOXXXXXXXXX
XXXXXXXXXXXOXXXOXXXXXXXXX
XXXXXXXXXXXOXXXOXXXXXXXXX
DXXXXXXXXXXOOOXOXXXXXXXXD
DXXXXXXXXXXOPXEOXXXXXXXXD
DXXXXXXXXXXOXOOOOOOOOXXXD
XXXXXXXXXXXOXXXOXXXXXXXXX
XXXXXXXXXEXXXOXOXXXXXXXXX
XXXXXXXXXXXOOOXOOOXXXXXXX
XXXXXXXXXXXXXOXXXEXXXXXXX
XXXXXXXXXXXXXOOOOOXXXXXXX
XXXXXXXXXXXXXXXXXXXXXXXXX
XXXXXXXXXXXXXXXXXXXXXXXXX
XXXXXXXXXXXXXXXXXXXXXXXXX
XXXXXXXXXXXXXXXXXXXXXXXXX
XXXXXXXXXXXXXXXXXXXXXXXXX
XXXXXXXXXXXDDDXXXXXXXXXXX
