XXXXXXXXXXXDDDXXXXXXXXXXX
XXXXXXXXXXXXXXXXXXXXXXXXX
XXXXXXXXXXXXXXXXXXXXXXXXX
XXXXXXXXXXXXXXXXXXXXXXXXX
XXXXXXXXXXXXXXXXXXXXXXXXX
XXXXXXXXXXXXXXXXXXXXXXXXX
XXXXXXEXXXXXXXXXXXEXXXXXX
XXXXOXXXXXXXXXXXXXXXOXXXX
XXXXOOOOOOOOOOOOOOOOOXXXX
XXXXOXXXXXXXXXXXXXXXOXXXX
XXXXXXXXXXXXXXXXXXXXXXXXX
DXXXXXXXXXXXXXXXXXXXXXXXD
DXXXXXXXXXXXPXXXXXXXXXXXD
DXXXXXXXXXXXXXXXXXXXXXXXD
XXXXXXXXXXXXXXXXXXXXXXXXX
XXXXXXXXXXXXXXXXXXXXXXXXX
XXXXXXXXXXOXXXOXXXXXXXXXX
XXXXXXXXXXOXXXOXXXXXXXXXX
XXXXXXXXXXOXEXOXXXXXXXXXX
XXXXXXXXXXOXEXOXXXXXXXXXX
XXXXOOOOOOOXEXOOOOOOOXXXX
XXXXXXXXXXXXXXXXXXXXXXXXX
XXXXXXXXXXXXXXXXXXXXXXXXX
XXXXXXXXXXXXXXXXXXXXXXXXX
XXXXXXXXXXXDDDXXXXXXXXXXX
