XXXXXXXXXXXDDDXXXXXXXXXXX
XXXXXXXXXXXXXXXXXXXXXXXXX
XXOXOXOXOXOXOXOXOXOXOXOXX
XXOXXXXXXXXXXXXXXXXXXXOXX
XXOXXXXXXXXXEXXXXXXXXXOXX
XXOXXXXXXXXXXXXXXXXXXXOXX
XXOXXXXXXXXXXXXXXXXXXXOXX
XXOXXXXXXXXXXXXXXXXXXXOXX
XXOXXXXXOXEXXXEXOXXXXXOXX
XXOXXXXXOXXXXXXXOXXXXXOXX
XXOXXXXXOXXXXXXXOXXXXXOXX
DXOXXXXXOXXXXXXXOXXXXXOXD
DXOXXXXXOXXXPXXXOXXXXXOXD
DXOXXXXXOXXXXXXXOXXXXXOXD
XXOXXXXXOXXXXXXXOXXXXXOXX
XXOXXXXXOXXXXXXXOXXXXXOXX
XXOXXEXXOXOXOXOXOXXEXXOXX
XXOXXXXXXXXXXXXXXXXXXXOXX
XXOXXXXXXXXXEXXXXXXXXXOXX
XXOXXXXXXXXXXXXXXXXXXXOXX
XXOXXXXXXXXXXXXXXXXXXXOXX
XXOXXXXXXXXXXXXXXXXXXXOXX
XXOXXXXXXXXXXXXXXXXXXXOXX
XXXXXXXXXXXXXXXXXXXXXXXXX
XXXXXXXXXXXDDDXXXXXXXXXXX
