XXXXXXXXXXODDDOXXXXXXXXXX
XXXXXXXXXXOXXXOXXXXXXXXXX
XXXXXXXXXXOXXXOXXXXXXXXXX
XXXXXXXXXXOXXXOXXXXXXXXXX
XXXXXXXXXXOXEXOXXXXXXXXXX
XXXXXXXXXXOXXXOXXXXXXXXXX
XXXXXXXXXXOXXXOXXXXXXXXXX
XXXXXXXXXXOXXXOXXXXXXXXXX
XXXXXXXXXXOXXXOXXXXXXXXXX
XXXXXXXXXXOXXXOXXXXXXXXXX
OOOOOOOOOOOXXXOOOOOOOOOOO
DXXXXXXXXXXXXXXXXXXXXXXXD
DXXXEXXXXXXXPXXXXXXXEXXXD
DXXXXXXXXXXXXXXXXXXXXXXXD
OOOOOOOOOOOXXXOOOOOOOOOOO
XXXXXXXXXXOXXXOXXXXXXXXXX
XXXXXXXXXXOXXXOXXXXXXXXXX
XXXXXXXXXXOXXXOXXXXXXXXXX
XXXXXXXXXXOXXXOXXXXXXXXXX
XXXXXXXXXXOXXXOXXXXXXXXXX
XXXXXXXXXXOXEXOXXXXXXXXXX
XXXXXXXXXXOXXXOXXXXXXXXXX
XXXXXXXXXXOXXXOXXXXXXXXXX
XXXXXXXXXXOXXXOXXXXXXXXXX
XXXXXXXXXXODDDOXXXXXXXXXX
