XXXXXXXXXXXDDDXXXXXXXXXXX
XXXXXXXXXXXXXXXXXXXXXXXXX
XXXXXXOXOXOXOXOXOXOXXXXXX
XXXXXXXXXXXXOXXXXXXXXXXXX
XXXXXXXXXXXXOXXXXXXXXXXXX
XXXXXXXEXXXXOXXXXEXXXXXXX
XXXXXXXXXXXXOXXXXXXXXXXXX
XXXXXXXXXXXXOXXXXXXXXXXXX
XXXXXXXXXXXXOXXXXXXXXXXXX
XXXXXXXOXEXXOXXXXXXXXXXXX
XXXXXXXOXXEXOXXXXXXXXXXXX
DXXXXXXXXOXOXXXXXXXXXXXXD
DXXXXXXXXXXXPXXXXXXXXXXXD
DXXXXXXXXXXXXXXXXXXXXXXXD
XXXXXXXXXXXXXXXXXXXXXXXXX
XXXXXXOXOXOXOXOXOXOXXXXXX
XXXXXXXXXXXXOXXXXXXXXXXXX
XXXXXXXXXXXXOXXXXXXXXXXXX
XXXXXXXXXXXXOXXXXXXXXXXXX
XXXXXXXXXXXXOXXXXXXXXXXXX
XXXXXXXXXXXXOXXXXXXXXXXXX
XXXXXXXXXXXXOXXXXXXXXXXXX
XXXXXXXXXXXXOXXXXXXXXXXXX
XXXXXXXXXXXXXXXXXXXXXXXXX
XXXXXXXXXXXDDDXXXXXXXXXXX
