XXXXXXXXXXXDDDXXXXXXXXXXX
XXXXXXXXXXXXXXXXXXXXXXXXX
XXXXXXXXXXXXXXXXXXXXXXXXX
XXXXXXXXXXXXXXXXXXXXXXXXX
XXXXXXXXXXXXXXXXXXXXXXXXX
XXXXXXXXXXXEXOXEXXXXXXXXX
XXXXXXXXXXXXXOXXXXXXXXXXX
XXXXXXXXXOXOXOXOXOXXXXXXX
XXXXXXXXXOXOXOXOXOXXXXXXX
XXXXXXXXXOXOXOXOXOXXXXXXX
XXXXXXXXXOXOXOXOXOXXXXXXX
DXXXXXXXXXXXXOXXXXXXXXXXD
DXXXXXXXXEXXXPXXXEXXXXXXD
DXXXXXXXXXXXXXXXXXXXXXXXD
XXXXXXXXXOXOXOXOXOXXXXXXX
XXXXXXXXXOXOXOXOXOXXXXXXX
XXXXXXXXXOXOXOXOXOXXXXXXX
XXXXXXXXXOXOXOXOXOXXXXXXX
XXXXXXXXXOXXXEXXXOXXXXXXX
XXXXXXXXXOXXXXXXXOXXXXXXX
XXXXXXXXXXXXXXXXXXXXXXXXX
XXXXXXXXXXXXXXXXXXXXXXXXX
XXXXXXXXXXXXXXXXXXXXXXXXX
XXXXXXXXXXXXXXXXXXXXXXXXX
XXXXXXXXXXXDDDXXXXXXXXXXX
