XXXXXXXXXXXDDDXXXXXXXXXXX
XXXXXXXXXXXXXXXXXXXXXXXXX
XXXXXXXXXXXXXXXXXXXXXXXXX
XXXXXXXXXXXXXXXXXXXXXXXXX
XXXXXXXXXXXXXXXXXXXXXXXXX
XXXXXXXXXXXXXXXXXXXXXXXXX
XXXXXXXXXXXXXXXXXXXXXXXXX
XXXXXXXOOOOOOOOOOOXXXXXXX
XXXXXXXOXXXXXXXXXOXXXXXXX
XXXXXXXOXOOOOOOOXOXXXXXXX
XXXXXXXOXOXXXXXOXOXXXXXXX
DXXXXXXOXOXOXOXOXOEXXXXXD
DXXXXXXXEOXOPOXXXOEXXXXXD
DXXXXXXOXOXOOOXOXOEXXXXXD
XXXXXXXOXOXXEXXOXOXXXXXXX
XXXXXXXOXOOOOOOOXOXXXXXXX
XXXXXXXOXXXXXXXXXOXXXXXXX
XXXXXXXOOOOOOOOOOOXXXXXXX
XXXXXXXXXXXXXXXXXXXXXXXXX
XXXXXXXXXXXXXXXXXXXXXXXXX
XXXXXXXXXXXXXXXXXXXXXXXXX
XXXXXXXXXXXXXXXXXXXXXXXXX
XXXXXXXXXXXXXXXXXXXXXXXXX
XXXXXXXXXXXXXXXXXXXXXXXXX
XXXXXXXXXXXDDDXXXXXXXXXXX
