XXXXXXXXXXXDDDXXXXXXXXXXX
XXXXXXXXXXXXXXXXXXXXXXXXX
XXXXXXXXXXXXXXXXXXXXXXXXX
XXXXXXXXXXXXXXXXXXXXXXXXX
XXXXXXXXXXXXXXXXXXXXXXXXX
XXXXXXXXXOEOOOEOXXXXXXXXX
XXXXXXXXXOXOXOXOXXXXXXXXX
XXXXXXXXXOXOXOXOXXXXXXXXX
XXXXXXXXXOXOXOXOXXXXXXXXX
XXXXXXXXXOXOXOXOXXXXXXXXX
XXXXXXXXXOXOXOXOXXXXXXXXX
DXXXXXXXXOXOXOXOXXXXXXXXD
DXXXXXXXXOXOPOXOXXXXXXXXD
DXXXXXXXXXXXXXXXXXXXXXXXD
XXXXXXXXXOXOXOXOXXXXXXXXX
XXXXXXXXXOXOXOXOXXXXXXXXX
XXXXXXXXXOXOXOXOXXXXXXXXX
XXXXXXXXXOXOXOXOXXXXXXXXX
XXXXXXXXXOXOEOXOXXXXXXXXX
XXXXXXXXXOOOOOOOXXXXXXXXX
XXXXXXXXXXXXXXXXXXXXXXXXX
XXXXXXXXXXXXXXXXXXXXXXXXX
XXXXXXXXXXXXXXXXXXXXXXXXX
XXXXXXXXXXXXXXXXXXXXXXXXX
XXXXXXXXXXXDDDXXXXXXXXXXX
