
X,X,X,X,X,X,X,X,X,X,X,D,D,D,X,X,X,X,X,X,X,X,X,X,X
X,E,O,X,X,X,X,X,X,X,X,X,X,X,X,X,X,X,X,X,X,X,O,E,X
X,O,O,X,X,X,X,X,X,X,X,X,X,X,X,X,X,X,X,X,X,X,O,O,X
X,X,X,X,X,X,X,X,X,X,X,X,X,X,X,X,O,O,X,X,X,X,X,X,X
X,X,X,X,X,X,X,X,X,X,X,X,X,X,X,X,O,O,X,X,X,X,X,X,X
X,X,X,X,X,X,X,X,X,X,X,X,X,X,X,X,X,X,X,X,X,X,X,X,X
X,X,X,X,X,X,X,O,O,X,X,X,X,X,X,X,X,X,X,X,X,X,X,X,X
X,X,X,X,X,X,X,O,O,O,X,X,X,X,X,X,X,X,X,X,X,X,X,X,X
X,X,X,X,X,X,X,O,O,O,X,X,X,X,X,X,X,X,X,X,X,X,X,X,X
X,X,X,X,X,X,X,X,X,X,X,X,X,X,X,X,X,O,O,O,X,X,X,X,X
X,X,X,X,X,X,X,X,X,X,X,X,X,X,X,X,X,O,O,O,X,X,X,X,X
D,X,X,X,X,X,X,X,X,X,X,X,X,X,X,X,X,X,O,O,X,X,X,X,D
D,X,X,X,X,X,X,X,X,X,X,X,P,X,X,X,X,X,X,X,X,X,X,X,D
D,X,X,X,X,X,X,X,X,X,X,X,X,X,X,X,X,X,X,X,X,X,X,X,D
X,X,X,X,X,X,X,X,X,X,X,X,X,X,X,X,X,X,X,X,X,X,X,X,X
X,X,X,X,X,X,X,X,X,X,X,X,X,X,X,O,O,O,O,X,X,X,X,X,X
X,X,X,O,O,O,O,O,O,X,X,X,X,X,X,O,O,O,O,X,X,X,X,X,X
X,X,X,O,O,O,O,O,O,X,X,X,X,X,X,O,O,O,O,X,X,X,X,X,X
X,X,X,O,O,O,O,O,O,X,X,X,X,X,X,O,O,O,O,X,X,X,X,X,X
X,X,X,O,O,O,O,O,O,X,X,X,X,X,X,X,X,X,X,X,X,X,X,X,X
X,X,X,O,O,O,O,O,O,X,X,X,X,X,X,X,X,X,X,X,X,X,X,X,X
X,X,X,X,X,X,X,X,X,X,X,X,X,X,X,X,X,X,X,X,X,X,X,X,X
X,O,O,X,X,X,X,X,X,X,X,X,X,X,X,X,X,X,X,X,X,X,O,O,X
X,E,O,X,X,X,X,X,X,X,X,X,X,X,X,X,X,X,X,X,X,X,O,E,X
X,X,X,X,X,X,X,X,X,X,X,D,D,D,X,X,X,X,X,X,X,X,X,X,X
