XXXXXXXXXXXDDDXXXXXXXXXXX
XXXXXXXXXXXXXXXXXXXXXXXXX
XXXXXXXXXXXXXXXXXXXXXXXXX
XXXXXXXXXXXXXXXXXXXXXXXXX
XXXXXXXXXXXXXXXXXXXXXXXXX
XXXXXXXXXXXXXXXXXXXXXXXXX
XXXXXXXXXXXEXXXXXXXXXXXXX
XXXXXXXXXXXEXXXXXXXXXXXXX
XXXXXXXXXXXXXXXXXXXXXXXXX
XXXXXXOOOOOOOOOOXXXXXXXXX
XXXXXXXXXXXXXXXOXXXXXXXXX
DXXXXXXXXXXXXXXOXXXXXXXXD
DXXXXXXXXXXXPXXOXXXXXXXXD
DXXXXXXXXXXXXXXOXXXXXXXXD
XXXXXXOOOOOOOOOOXXXXXXXXX
XXXXXXOXXXXXXXXXXXXXXXXXX
XXXXXXOXXXXXXXXXXXXXXXXXX
XXXXXXOXXXEEXXXXXXXXXXXXX
XXXXXXOXXXXXXXXXXXXXXXXXX
XXXXXXOXXXXXXXXXXXXXXXXXX
XXXXXXOXXXXXXXXXXXXXXXXXX
XXXXXXOOOOOOOOOOXXXXXXXXX
XXXXXXXXXXXXXXXXXXXXXXXXX
XXXXXXXXXXXXXXXXXXXXXXXXX
XXXXXXXXXXXDDDXXXXXXXXXXX
