XXXXXXXXXXXDDDXXXXXXXXXXX
XXXXXXXXXXXXXXXXXXXXXXXXX
XXXXXXXXXXXXXXXXXXXXXXXXX
XXXXXXOOOOOOOOOOOOOXXXXXX
XXXXXXOXXXXXXXXXXXOXXXXXX
XXXXXXOXXXXXXXXXXXOXXXXXX
XXXXXXOXXXXXXXXXXXOXXXXXX
XXXXXXOXXXXXXOXXXXOXXXXXX
XXXXXXOXXXXXXOXXXXOXXXXXX
XXXXXXOXXXXXXOXXXXOXXXXXX
XXXXXXOXXXXXXOXXXXOXXXXXX
DXXXXXOXXXXXXXXXXXOXXXXXD
DXXXXEOXXXXXPXXXXXOXEXXXD
DXXXXXOXXXXXXXXXXXOXXXXXD
XXXXXXOXXXXXXXXXXXOXXXXXX
XXXXXXOXXXXXXXXXXXOXXXXXX
XXXXXXOXXXXOXXXXXXOXXXXXX
XXXXXXOXOOOOXXXXOEOXXXXXX
XXXXXXOEOOOOOXOOOOOXXXXXX
XXXXXXOOOOOOOXOOOOOXXXXXX
XXXXXXOOOOOOOXOOOOOXXXXXX
XXXXXXOOOOOOOXOOOOOXXXXXX
XXXXXXXXXXXXXXXXXXXXXXXXX
XXXXXXXXXXXXXXXXXXXXXXXXX
XXXXXXXXXXXDDDXXXXXXXXXXX
