XXXXXXXXXXXDDDXXXXXXXXXXX
XXXXXXXXXXXXXXXXXXXXXXXXX
XXXXXXXXXXXXEXXXXXXXXXXXX
XXXXXXXXXXXXXXXXXXXXXXXXX
XXXXXXXXXXXOXXXXXXXXXXXXX
XXXXXXXXXXXOXOXXXXXXXXXXX
XXXXXXXXXXXOXXXXXXXXXXXXX
XXXXXXXXXXXXXXXXXXXXXXXXX
XXXXOXOXXXXXXXXXXOXXXXXXX
XXXXXXOXXXXXXXXXXOXXXXXXX
XXXXXXOXXXXXXXXXXOXXXXXXX
DXXXXXOXXXXXXXXXXXXXXXXXD
DXEXXXOXXXXXPXXXXXXXXXEXD
DXXXXXOXXXXXXXXXXXXXXXXXD
XXXXOXOXOXXXXXXXXXXXXXXXX
XXXXXXXXXXOXXXXXXXXXXXXXX
XXXXXXXXXOXOXXXXXXXXXXXXX
XXXXXXXXXXOXXXXXXXXXXXXXX
XXXXXXXXXXXXXXXXXXOXOXXXX
XXXXXXXXXXXXXXXXXXOXOXXXX
XXXXXXXXXXXXXXXXXXOXOXXXX
XXXXXXXXXXXXXXXXXXXXXXXXX
XXXXXXXXXXXXEXXXXXXXXXXXX
XXXXXXXXXXXXXXXXXXXXXXXXX
XXXXXXXXXXXDDDXXXXXXXXXXX
