XXXXXXXXXXXDDDXXXXXXXXXXX
XXXXXXXXXXXXXXXXXXXXXXXXX
XXXXXXXXXXXXXXXXXXXXXXXXX
XXXXXXXXXXXXXXXXXXXXXXXXX
XXXXXXXXXXXXXXXXXXXXXXXXX
XXXXXXXXXXXXXXXXXXXXXXXXX
XXXXXXEXXXXXXXXXXXEXXXXXX
XXXXOXXXXXXXXXXXXXXXOXXXX
XXXXXOXOXOXOXOXOXOXOXXXXX
XXXXOXXXXXXXXXXXXXXXOXXXX
XXXXXXXXXXXXXXXXXXXXXXXXX
DXXXXXXXXXXXXXXXXXXXXXXXD
DXXXXXXXXXXXPXXXXXXXXXXXD
DXXXXXXXXXXXXXXXXXXXXXXXD
XXXXXXXXXXXXXXXXXXXXXXXXX
XXXXXXXXXXXXXXXXXXXXXXXXX
XXXXXXXXXXOXXXOXXXXXXXXXX
XXXXXXXXXXXXXXXXXXXXXXXXX
XXXXXXXXXXOXEXOXXXXXXXXXX
XXXXXXXXXXXXEXXXXXXXXXXXX
XXXXOXOXOXOXEXOXOXOXOXXXX
XXXXXXXXXXXXXXXXXXXXXXXXX
XXXXXXXXXXXXXXXXXXXXXXXXX
XXXXXXXXXXXXXXXXXXXXXXXXX
XXXXXXXXXXXDDDXXXXXXXXXXX
