XXXXXXXXXXXDDDXXXXXXXXXXX
XXXXXXXXXXXXXXXXXXXXXXXXX
XXXXXXXXXXXXXXXXXXXXXXXXX
XXXXXXOXOXOXOXOXOXOXXXXXX
XXXXXXOXXXXXXXXXXXOXXXXXX
XXXXXXOXXXXXXXXXXXOXXXXXX
XXXXXXOXXXXXXXXXXXOXXXXXX
XXXXXXOXXXXXOXXXXXOXXXXXX
XXXXXXOXXXXXOXXXXXOXXXXXX
XXXXXXOXXXXXOXXXXXOXXXXXX
XXXXXXOXXXXXOXXXXXOXXXXXX
DXXXXXOXXXXXXXXXXXOXXXXXD
DXXEXXOXXXXXPXXXXXOXEXXXD
DXXXXXOXXXXXXXXXXXOXXXXXD
XXXXXXOXXXXXXXXXXXOXXXXXX
XXXXXXOXEXXXXXXXXXOXXXXXX
XXXXXXOXXXXXXXXEXXOXXXXXX
XXXXXXOXOXOXXXXXXXOXXXXXX
XXXXXXOXOXOXXXOXOXOXXXXXX
XXXXXXOXOXOXXXOXOXOXXXXXX
XXXXXXOXOXOXXXOXOXOXXXXXX
XXXXXXOXOXOXXXOXOXOXXXXXX
XXXXXXXXXXXXXXOXXXXXXXXXX
XXXXXXXXXXXXXXXXXXXXXXXXX
XXXXXXXXXXXDDDXXXXXXXXXXX
