XXXXXXXXXXXDDDXXXXXXXXXXX
XXXXXXXXXXXXXXXXXXXXXXXXX
XXXXXXXOOOOXEXOOOOXXXXXXX
XXXXXXXOXXXXXXXXXOXXXXXXX
XXXXXXXOXXXXXXXXXOXXXXXXX
XXXXXXXOXXXXXXXXXOXXXXXXX
XXXXXXXOXXXXXXXXXOXXXXXXX
XXXXXXXOXXXXXXXXXOXXXXXXX
XXXXXXXOXXXXXXXXXOXXXXXXX
XXXXXXXOXXXXXXXXXOXXXXXXX
XXXXXXXOXXXXXXXXXOXXXXXXX
DXXXXXXXXXXXXXXXXXXXXXXXD
DXXXXXXEXXXXPXXXXEXXXXXXD
DXXXXXXXXXXXXXXXXXXXXXXXD
XXXXXXXOXXXXXXXXXOXXXXXXX
XXXXXXXOXXXXXXXXXOXXXXXXX
XXXXXXXOXXXXXXXXXOXXXXXXX
XXXXXXXOXXXXXXXXXOXXXXXXX
XXXXXXXOXXXXXXXXXOXXXXXXX
XXXXXXXOXXXXXXXXXOXXXXXXX
XXXXXXXOXXXXXXXXXOXXXXXXX
XXXXXXXOXXXXXXXXXOXXXXXXX
XXXXXXXOOOOXEXOOOOXXXXXXX
XXXXXXXXXXXXXXXXXXXXXXXXX
XXXXXXXXXXXDDDXXXXXXXXXXX
