XXXXXXXXXXXDDDXXXXXXXXXXX
XXXXXXXXXXXXXXXXXXXXXXXXX
XXXXXXXXXXXXXXXXXXXXXXXXX
XXXXXXXXXXXXXXXXXXXXXXXXX
XXXXXXXXXXXXXXXXXXXXXXXXX
XXXXXXXXXXXXXXXXXXXXXXXXX
XXXXXXEXXXXXXXXXXXEXXXXXX
XXXXOXXXXXXXXXXXXXXXOXXXX
XXXXXOXOXOXOXOXOXOXOXXXXX
XXXXOXXXXXXXXXXXXXXXOXXXX
XXXXXXXXXXXXXXXXXXXXXXXXX
DXXXXXXXXXXXXXXXXXXXXXXXD
DXXXXXXXXXXXPXXXXXXXXXXXD
DXXXXXXXXXXXXXXXXXXXXXXXD
XXXXXXXXXXXXXXXXXXXXXXXXX
XXXXXXXXXXXXXXXXXXXXXXXXX
XXXXXXXXXOXXXXXOXXXXXXXXX
XXXXXXXXXXXXXXXXXXXXXXXXX
XXXXXXXXXOXXEXXOXXXXXXXXX
XXXXXXXXXXXXEXXXXXXXXXXXX
XXXXOXOXOXXXEXXXOXOXOXXXX
XXXXXXXXXXXXXXXXXXXXXXXXX
XXXXXXXXXXXXXXXXXXXXXXXXX
XXXXXXXXXXXXXXXXXXXXXXXXX
XXXXXXXXXXXDDDXXXXXXXXXXX
