XXXXXXXXXXXDDDXXXXXXXXXXX
XXXXXXXXXXXXXXXXXXXXXXXXX
XXXEXXXXXXXXXXXXXXXXXEXXX
XXXXXXXXXXXXXXXXOOXXXXXXX
XXXXXXXXXXXXXXXXOOXXXXXXX
XXXXXXXXXXXXXXXXXXXXXXXXX
XXXXXXXOXXXXXXXXXXXXXXXXX
XXXXXXXOXOXXXXXXXXXXXXXXX
XXXXXXXOXOXXXXXXXXXXXXXXX
XXXXXXXXXXXXXXXXXOXOXXXXX
XXXXXXXXXXXXXXXXXOXOXXXXX
DXXXXXXXXXXXXXXXXXXOXXXXD
DXXXXXXXXXXXPXXXXXXXXXXXD
DXXXXXXXXXXXXXXXXXXXXXXXD
XXXXXXXXXXXXXXXXXXXXXXXXX
XXXXXXXXXXXXXXXOXOXOXXXXX
XXXOXOXOXXXXXXXOXOXOXXXXX
XXXOXOXOXXXXXXXOXOXOXXXXX
XXXOXOXOXXXXXXXOXOXOXXXXX
XXXOXOXOXXXXXXXXXXXXXXXXX
XXXOXOXOXXXXXXXXXXXXXXXXX
XXXEXXXXXXXXXXXXXXXXXEXXX
XXXXXXXXXXXXXXXXXXXXXXXXX
XXXXXXXXXXXXXXXXXXXXXXXXX
XXXXXXXXXXXDDDXXXXXXXXXXX
