XXXXXXXXXXXDDDXXXXXXXXXXX
XXXXXXXXXXXXXXXXXXXXXXXXX
XXXXXXXXXXXXXXXXXXXXXXXXX
XXXXXXXXXXXXXXXXXXXXXXXXX
XXXOXOXOXOXOXOXOXOXXXXXXX
XXXOXXXXXXOXXXXEXXXXXXXXX
XXXOXXXXXXOXXXXXXXXXXXXXX
XXXOXXEXXXOXOXOXOXOXXXXXX
XXXOXXEXXXOXXXXXXXXXXXXXX
XXXOXXXXXXOXXXXXXXEXXXXXX
XXXOXXXXXXOXXXXXXXXXXXXXX
DXXOXXXXXXOXXXXXOXXXXXXXD
DXXOXXXXXXOXPXXXOXXXXXXXD
DXXXOXXXXXOXOXOXOXXXXXXXD
XXXXXOXXXXOXXXXXXXXXXXXXX
XXXXXXOXXXOXXXXXXXXXXXXXX
XXXXXXOXXXOXXXXXXXXXXXXXX
XXXXXXOXXXXXXXXXXXXXXXXXX
XXXXXXXXXXXXXXXXXXXXXXXXX
XXXXXXXXXXXXXXXXXXXXXXXXX
XXXXXXXXXXXXXXXXXXXXXXXXX
XXXXXXXXXXXXXXXXXXXXXXXXX
XXXXXXXXXXXXXXXXXXXXXXXXX
XXXXXXXXXXXXXXXXXXXXXXXXX
XXXXXXXXXXXDDDXXXXXXXXXXX
