XXXXXXXXXXXDDDXXXXXXXXXXX
XXXXXXXXXXXXXXXXXXXXXXXXX
XXXXXXXXXXXXXXXXXXXXXXXXX
XXXXXXEEXXXXXXXXXXXXXXXXX
XXXXXXXXXXXXXXXXXXXXXXXXX
XXXXXXXXXXXXXXXXXXXXXXXXX
XXXXXXXXXXXXXXXXXXXXXXXXX
XXXXXXXXXXXXXXXXXXXXXXXXX
XXXXXXXXXXXXXXXXXXXXXXXXX
XXXXXOXXOOOOOOOXXXXXXXXXX
XXXXXOXXOXXXXXOXXXXXXXXXX
DXXXXOXXOXOXXXOXXXXXXXXXD
DXXXXOXXXXOXPXOXXXXXXXXXD
DXXXXOXXOOOOOOOXXXXXXXXXD
XXXXXOXXOXXXXXXXXXXXXXXXX
XXXXXOXXOOOOOOXXXXXXXXXXX
XXXXXOXXXXXXEOXXXXXXXXXXX
XXXXXOOOOOOOOOXXXXXXXXXXX
XXXXXXXXXXXXXXXXXXXXXXXXX
XXXXXXXXXXXXXXXXXXXXXXXXX
XXXXXXXXXXXXXXXXXXXXXXXXX
XXXXXXXXXXXXXXXXXXXXXXXXX
XXXXXXXXXXXXXXXXXXXXXXXXX
XXXXXXXXXXXXXXXXXXXXXXXXX
XXXXXXXXXXXDDDXXXXXXXXXXX
