XXXXXXXXXXXDDDXXXXXXXXXXX
XXXXXXXXXXXXXXXXXXXXXXXXX
XXXXXXXXXXXXEXXXXXXXXXXXX
XXXXXXXXXXXXXXXXXXXXXXXXX
XXXXXXXXXXXOXXXXXXXXXXXXX
XXXXXXXXXXXOOOXXXXXXXXXXX
XXXXXXXXXXXOXXXXXXXXXXXXX
XXXXXXXXXXXXXXXXXXXXXXXXX
XXXOOOOXXXXXXXXXXOXXXXXXX
XXXXXXOXXXXXXXXXXOXXXXXXX
XXXXXXOXXXXXXXXXXOXXXXXXX
DXXXXXOXXXXXXXXXXXXXXXXXD
DXEXXXOXXXXXPXXXXXXXXXEXD
DXXXXXOXXXXXXXXXXXXXXXXXD
XXXOOOOOOOXXXXXXXXXXXXXXX
XXXXXXXXXXOXXXXXXXXXXXXXX
XXXXXXXXXOOOXXXXXXXXXXXXX
XXXXXXXXXXOXXXXXXXXXXXXXX
XXXXXXXXXXXXXXXXXXOOOXXXX
XXXXXXXXXXXXXXXXXXOOOXXXX
XXXXXXXXXXXXXXXXXXOOOXXXX
XXXXXXXXXXXXXXXXXXXXXXXXX
XXXXXXXXXXXXEXXXXXXXXXXXX
XXXXXXXXXXXXXXXXXXXXXXXXX
XXXXXXXXXXXDDDXXXXXXXXXXX
