XXXXXXXXXXXDDDXXXXXXXXXXX
XXXXXXXXXXXXXXXXXXXXXXXXX
XXXXXXXOXOXXEXXOXOXXXXXXX
XXXXXXXOXXXXXXXXXOXXXXXXX
XXXXXXXOXXXXXXXXXOXXXXXXX
XXXXXXXOXXXXXXXXXOXXXXXXX
XXXXXXXOXXXXXXXXXOXXXXXXX
XXXXXXXOXXXXXXXXXOXXXXXXX
XXXXXXXOXXXXXXXXXOXXXXXXX
XXXXXXXOXXXXXXXXXOXXXXXXX
XXXXXXXOXXXXXXXXXOXXXXXXX
DXXXXXXXXXXXXXXXXXXXXXXXD
DXXXXXXEXXXXPXXXXEXXXXXXD
DXXXXXXXXXXXXXXXXXXXXXXXD
XXXXXXXOXXXXXXXXXOXXXXXXX
XXXXXXXOXXXXXXXXXOXXXXXXX
XXXXXXXOXXXXXXXXXOXXXXXXX
XXXXXXXOXXXXXXXXXOXXXXXXX
XXXXXXXOXXXXXXXXXOXXXXXXX
XXXXXXXOXXXXXXXXXOXXXXXXX
XXXXXXXOXXXXXXXXXOXXXXXXX
XXXXXXXOXXXXXXXXXOXXXXXXX
XXXXXXXOXOXXEXXOXOXXXXXXX
XXXXXXXXXXXXXXXXXXXXXXXXX
XXXXXXXXXXXDDDXXXXXXXXXXX
