XXXXXXXXXXXDDDXXXXXXXXXXX
XXXXXXXXXXXXXXXXXXXXXXXXX
XXXXXXXXXOXXXXXOXXXXXXXXX
XXXXXXXXXOXXXXXOXXXXXXXXX
XXXXXXXXXOXXEXXOXXXXXXXXX
XXXXXXXXXOXXXXXOXXXXXXXXX
XXXXXXXXXOXXXXXOXXXXXXXXX
XXXXXXXXXOXXXXXOXXXXXXXXX
XXXXXXXXXOXXXXXOXXXXXXXXX
XXXXXXXXXOXXXXXOXXXXXXXXX
XXXOOOOOOOXXXXXOOOOOOOXXX
DXXXXXXXXXXXXXXXXXXXXXXXD
DXXXEXXXXXXXPXXXXXXXEXXXD
DXXXXXXXXXXXXXXXXXXXXXXXD
XXXOOOOOOOXXXXXOOOOOOOXXX
XXXXXXXXXOXXXXXOXXXXXXXXX
XXXXXXXXXOXXXXXOXXXXXXXXX
XXXXXXXXXOXXXXXOXXXXXXXXX
XXXXXXXXXOXXXXXOXXXXXXXXX
XXXXXXXXXOXXXXXOXXXXXXXXX
XXXXXXXXXOXXEXXOXXXXXXXXX
XXXXXXXXXOXXXXXOXXXXXXXXX
XXXXXXXXXOXXXXXOXXXXXXXXX
XXXXXXXXXXXXXXXXXXXXXXXXX
XXXXXXXXXXXDDDXXXXXXXXXXX
