XXXXXXXXXXXDDDXXXXXXXXXXX
XXXXXXXXXXXXXXXXXXXXXXXXX
XXXXXXXXXXXXXXXXXXXXXXXXX
XXXXXXEXXXXXXXXXXXXXXXXXX
XXXXEXXXEXXXXXXXXXXXXXXXX
XXXXXXEXXXXXXXXXXXXXXXXXX
XXXXXXXXXXXXXXXXXXXXXXXXX
XXXXXXXXXXXXXXXXXXXXXXXXX
XXXXXXXXXXXXXXXXXXXXXXXXX
XXXXOXXXOXOXOXOXXXXXXXXXX
XXXXOXXXXXXXXXOXXXXXXXXXX
DXXXOXXXXXXXXXOXXXXXXXXXD
DXXXOXXXXXXXPXOXXXXXXXXXD
DXXXOXXXXXXXXXOXXXXXXXXXD
XXXXOXOXOXOXXXOXXXXXXXXXX
XXXXOXEXXEXXEXOXXXXXXXXXX
XXXXOXXXXXXXXXOXXXXXXXXXX
XXXXOXOXOXOXOXOXXXXXXXXXX
XXXXXXXXXXXXXXXXXXXXXXXXX
XXXXXXXXXXXXXXXXXXXXXXXXX
XXXXXXXXXXXXXXXXXXXXXXXXX
XXXXXXXXXXXXXXXXXXXXXXXXX
XXXXXXXXXXXXXXXXXXXXXXXXX
XXXXXXXXXXXXXXXXXXXXXXXXX
XXXXXXXXXXXDDDXXXXXXXXXXX
