X,X,X,X,X,X,X,X,X,X,X,D,D,D,X,X,X,X,X,X,X,X,X,X,X
X,X,X,X,X,X,X,X,X,X,X,X,X,X,X,X,X,X,X,X,X,X,X,X,X
X,X,X,X,X,X,X,O,O,O,O,X,E,X,O,O,O,O,X,X,X,X,X,X,X
X,X,X,X,X,X,X,O,X,X,X,X,X,X,X,X,X,O,X,X,X,X,X,X,X
X,X,X,X,X,X,X,O,X,X,X,X,X,X,X,X,X,O,X,X,X,X,X,X,X
X,X,X,X,X,X,X,O,X,X,X,X,X,X,X,X,X,O,X,X,X,X,X,X,X
X,X,X,X,X,X,X,O,X,X,X,X,X,X,X,X,X,O,X,X,X,X,X,X,X
X,X,X,X,X,X,X,O,X,X,X,X,X,X,X,X,X,O,X,X,X,X,X,X,X
X,X,X,X,X,X,X,O,X,X,X,X,X,X,X,X,X,O,X,X,X,X,X,X,X
X,X,X,X,X,X,X,O,X,X,X,X,X,X,X,X,X,O,X,X,X,X,X,X,X
X,X,X,X,X,X,X,O,X,X,X,X,X,X,X,X,X,O,X,X,X,X,X,X,X
D,X,X,X,X,X,X,X,X,X,X,X,X,X,X,X,X,X,X,X,X,X,X,X,D
D,X,X,X,X,X,X,E,X,X,X,X,P,X,X,X,X,E,X,X,X,X,X,X,D
D,X,X,X,X,X,X,X,X,X,X,X,X,X,X,X,X,X,X,X,X,X,X,X,D
X,X,X,X,X,X,X,O,X,X,X,X,X,X,X,X,X,O,X,X,X,X,X,X,X
X,X,X,X,X,X,X,O,X,X,X,X,X,X,X,X,X,O,X,X,X,X,X,X,X
X,X,X,X,X,X,X,O,X,X,X,X,X,X,X,X,X,O,X,X,X,X,X,X,X
X,X,X,X,X,X,X,O,X,X,X,X,X,X,X,X,X,O,X,X,X,X,X,X,X
X,X,X,X,X,X,X,O,X,X,X,X,X,X,X,X,X,O,X,X,X,X,X,X,X
X,X,X,X,X,X,X,O,X,X,X,X,X,X,X,X,X,O,X,X,X,X,X,X,X
X,X,X,X,X,X,X,O,X,X,X,X,X,X,X,X,X,O,X,X,X,X,X,X,X
X,X,X,X,X,X,X,O,X,X,X,X,X,X,X,X,X,O,X,X,X,X,X,X,X
X,X,X,X,X,X,X,O,O,O,O,X,E,X,O,O,O,O,X,X,X,X,X,X,X
X,X,X,X,X,X,X,X,X,X,X,X,X,X,X,X,X,X,X,X,X,X,X,X,X
X,X,X,X,X,X,X,X,X,X,X,D,D,D,X,X,X,X,X,X,X,X,X,X,X
