XXXXXXXXXXXDDDXXXXXXXXXXX
XXXXXXXXXXXXXXXXXXXXXXXXX
XXXXXXXXXXXXXXXXXXXXXXXXX
XXXXXXXXXXXXXXXXXXXXXXXXX
XXXOXOXOXOXOXOXOXOXOXOXXX
XXXXXXXXXXXXXXEXXXXXXXXXX
XXXOXOXOXOXOXOXOXOXOXOXXX
XXXXXXXXXXXXXXXXXXXXXXXXX
XXXOXOXOEOXOXOXOXOXOXOXXX
XXXXXXXXXXXXXXXXXXXXXXXXX
XXXOXOXOXOXOXOXOXOXOXOXXX
DXXXXXXXXXXXXXXXXXXXXXXXD
DXXOXOXOXOXOPOXOXOXOXOXXD
DXXXXXXXXXXXXXXXXXXXXXXXD
XXXOXOXOXOXOXOXOXOXOXOXXX
XXXXXXEXXXXXXXXXXXXXEXXXX
XXXOXOXOXOXOXOXOXOXOXOXXX
XXXXXXXXXXXXEXXXXXXXXXXXX
XXXOXOXOXOXOXOXOXOXOXOXXX
XXXXXXXXXXXXXXXXXXXXXXXXX
XXXOXOXOXOXOXOXOXOXOXOXXX
XXXXXXXXXXXXXXXXXXXXXXXXX
XXXXXXXXXXXXXXXXXXXXXXXXX
XXXXXXXXXXXXXXXXXXXXXXXXX
XXXXXXXXXXXDDDXXXXXXXXXXX
