XXXXXXXXXXXDDDXXXXXXXXXXX
XXXXXXXXXXXXXXXXXXXXXXXXX
XXXXXXXXXXXXXXXXXXXXXXXXX
XXXXXXXXXXXXXXXXXXXXXXXXX
XXXXXXXXXXXXXXXXOXOXXXXXX
XXXXXXXXXXXXXXXXOXOXXXXXX
XXXXXXXXXXXXXXXXXXXXXXXXX
XXXXXXXXXXXXXXXXXXXXXXXXX
XXXXXXXXXXXXXXXEXXXXXXXXX
XXXXXXXXXXXXXXXXXXXXXXXXX
XXXXEXOXOXOXOXXXXXOXOXXXX
DXXXEXXXXXXXXXXXXXXXXXXXD
DXXXEXXXXXXXPXXXXXEXXXXXD
DXXXEXXXXXXXXXXXXXXXXXXXD
XXXXEXOXOXOXOXXXXXOXOXXXX
XXXXXXXXXXXXXXXEXXXXXXXXX
XXXXXXXXXXXXXXXXXXXXXXXXX
XXXXXXXXXXOXOXXXXXXXXXXXX
XXXXXXXXXXOXOXXXXXXXXXXXX
XXXXXXXXXXXXXXXXXXXXXXXXX
XXXXXXXXXXXXXXXXXXXXXXXXX
XXXXXXXXXXXXXXXXXXXXXXXXX
XXXXXXXXXXXXXXXXXXXXXXXXX
XXXXXXXXXXXXXXXXXXXXXXXXX
XXXXXXXXXXXDDDXXXXXXXXXXX
