XXXXXXXXXXXDDDXXXXXXXXXXX
XXXXXXXXXXXXXXXXXXXXXXXXX
XXXXXXXXXXXXXXXXXXXXXXXXX
XXXXXXXXXXXXXXXXXXXXXXXXX
XXXXXXXXXXXXXXXXXXXXXXXXX
XXXXXXXXXXXXXXXXXXXXXXXXX
XXXXXXXXXXXEXXXXXXXXXXXXX
XXXXXXXXXXXEXXXXXXXXXXXXX
XXXXXXXXXXXXXXXXXXXXXXXXX
XXXXXXOXOXOXOXOXXXXXXXXXX
XXXXXXXXXXXXXXXOXXXXXXXXX
DXXXXXXXXXXXXXXOXXXXXXXXD
DXXXXXXXXXXXPXXOXXXXXXXXD
DXXXXXXXXXXXXXXOXXXXXXXXD
XXXXXXOXOXOXOXOXXXXXXXXXX
XXXXXXOXXXXXXXXXXXXXXXXXX
XXXXXXOXXXXXXXXXXXXXXXXXX
XXXXXXOXXXEXEXXXXXXXXXXXX
XXXXXXOXXXXXXXXXXXXXXXXXX
XXXXXXOXXXXXXXXXXXXXXXXXX
XXXXXXOXXXXXXXXXXXXXXXXXX
XXXXXXOXOXOXOXOXXXXXXXXXX
XXXXXXXXXXXXXXXXXXXXXXXXX
XXXXXXXXXXXXXXXXXXXXXXXXX
XXXXXXXXXXXDDDXXXXXXXXXXX
